23 23 23 23 23 23 24 23 23 23 23 23 23 23 23 23 23 23 23 23 23 23 23 23 23 23 23 23 23 23 24 23 23 23 23 23 23 23 24 24 23 23 23 23 23 23 23 23 23 23 
23 23 24 24 23 23 23 23 23 23 23 23 23 23 23 23 23 23 23 23 24 23 23 23 23 23 23 23 23 24 23 23 23 23 23 23 23 23 23 23 23 23 24 24 23 23 23 23 23 23 
24 24 23 23 23 23 23 23 23 23 23 23 23 24 24 24 23 23 23 23 23 23 23 23 23 23 23 23 23 23 23 23 23 23 23 23 23 23 23 23 23 23 23 23 23 24 23 23 23 23 
24 23 23 23 23 23 23 23 23 23 23 23 23 23 23 23 23 23 23 23 23 23 23 23 23 23 23 23 23 23 23 23 23 23 23 23 23 23 23 23 23 23 23 23 23 23 23 23 23 23 
23 23 23 23 23 28 28 28 28 28 28 28 28 28 28 28 28 28 28 28 28 28 28 28 28 28 28 28 28 28 28 28 28 28 28 28 28 28 28 28 28 28 28 28 28 23 23 23 23 23 
23 23 23 23 26 10 10 10 10 10 10 10 10 10 10 10 10 10 10 10 10 10 10 10 10 10 10 10 10 10 10 10 10 10 10 10 10 10 10 10 10 10 10 10 10 27 23 23 23 23 
23 23 23 23 26 10 10 10 10 10 10 10 10 10 10 10 10 10 10 10 10 10 10 10 10 10 10 10 10 10 10 10 10 10 10 10 10 10 10 10 10 10 10 10 10 27 23 23 23 23 
23 24 23 23 26 10 10 10 10 10 10 10 10 10 10 10 10 10 10 32 39 39 39 39 39 39 39 39 39 38 10 10 10 10 10 10 10 10 10 10 10 10 10 10 10 27 23 23 23 23 
23 24 23 23 26 10 10 10 10 10 10 10 10 10 10 10 10 10 10 33 20 20 20 20 20 20 20 20 20 37 10 10 10 10 10 10 10 10 10 10 10 10 10 10 10 27 23 24 23 23 
23 23 23 23 26 10 10 10 10 10 10 10 10 10 10 10 10 10 10 33 20 20 20 20 20 20 20 20 20 37 10 10 10 10 10 10 10 10 10 10 10 10 10 10 10 27 23 23 23 23 
23 23 23 23 26 10 10 10 10 10 10 10 10 10 10 10 10 10 10 33 20 20 20 20 20 20 20 20 20 37 10 10 10 10 10 10 10 10 10 10 10 10 10 10 10 27 23 23 23 23 
23 23 23 23 26 10 10 10 10 10 10 10 10 10 10 10 10 10 10 33 20 20 20 20 20 20 20 20 20 37 10 10 10 10 10 10 10 10 10 10 10 10 10 10 10 27 23 23 23 23 
23 23 23 23 26 10 10 10 10 10 10 10 10 10 10 10 10 10 10 34 35 20 20 20 20 20 20 20 35 36 10 10 10 10 10 10 10 10 10 10 10 10 10 10 10 27 23 23 23 23 
23 23 23 23 26 10 10 10 10 10 10 10 10 10 10 10 10 10 10 12 20 20 20 20 20 20 20 20 20 16 10 10 10 10 10 10 10 10 10 10 10 10 10 10 10 27 23 24 23 23 
23 23 24 23 26 10 10 10 10 10 10 10 10 10 10 10 10 10 10 12 20 20 19 20 20 20 20 19 20 16 10 10 10 10 10 10 10 10 10 10 10 10 10 10 10 27 23 23 23 23 
23 23 23 23 26 10 10 10 10 10 10 10 10 10 10 10 10 10 10 13 20 20 20 20 20 20 20 20 20 15 10 10 10 10 10 10 10 10 10 10 10 10 10 10 10 27 23 23 23 23 
23 23 23 23 26 10 10 10 10 10 10 10 10 10 10 10 10 10 10 10 13 20 20 20 19 20 20 20 15 10 10 10 10 10 10 10 10 10 10 10 10 10 10 10 10 27 23 23 23 23 
23 23 23 23 26 10 10 10 10 10 10 10 10 10 10 10 10 10 10 10 10 13 20 20 20 20 20 15 10 10 10 10 10 10 10 10 10 10 10 10 10 10 10 10 10 27 23 23 23 23 
23 23 23 23 26 10 10 10 10 10 10 10 10 10 10 10 10 10 10 10 10 10 10 12 20 16 10 10 10 10 10 10 10 10 10 10 10 10 10 10 10 10 10 10 10 27 23 23 23 23 
23 23 23 23 26 10 10 10 10 10 10 10 10 10 10 10 10 10 10 10 10 10 10 12 20 16 10 10 10 10 10 10 10 10 10 10 10 10 10 10 10 10 10 10 10 27 23 23 23 23 
23 23 23 23 26 10 10 10 10 10 10 10 10 10 10 10 10 10 10 10 10 10 11 20 20 20 17 10 10 10 10 10 10 10 10 10 10 10 10 10 10 10 10 10 10 27 23 23 23 24 
23 23 23 23 26 10 10 10 10 10 10 10 10 10 10 10 10 10 10 10 10 10 12 20 20 20 20 18 18 18 18 18 18 18 17 10 10 10 10 10 10 10 10 10 10 27 23 23 23 23 
23 23 23 23 26 10 10 10 10 10 10 10 10 10 10 10 10 10 10 10 10 10 12 20 20 20 20 20 19 20 20 20 20 20 16 10 10 10 10 10 10 10 10 10 10 27 23 23 23 23 
23 23 23 23 26 10 10 10 10 10 10 10 10 10 10 10 10 10 10 10 10 10 12 19 20 20 20 14 14 14 14 14 14 14 15 10 10 10 10 10 10 10 10 10 10 27 23 23 23 23 
23 23 24 23 26 10 10 10 10 10 10 10 10 10 11 18 18 18 18 18 18 18 12 20 20 20 16 10 10 10 10 10 10 10 10 10 10 10 10 10 10 10 10 10 10 27 23 23 24 23 
23 23 23 23 26 10 10 10 10 10 10 10 10 10 12 20 20 20 20 20 20 20 20 20 20 20 16 10 10 10 10 10 10 10 10 10 10 10 10 10 10 10 10 10 10 27 23 23 24 23 
23 23 23 23 26 10 10 10 10 10 10 10 10 10 13 14 14 14 14 14 14 14 20 20 20 20 16 10 10 10 10 10 10 10 10 10 10 10 10 10 10 10 10 10 10 27 23 23 24 23 
23 23 23 23 26 10 10 10 10 10 10 10 10 10 10 10 10 10 10 10 10 10 12 20 19 20 16 10 10 10 10 10 10 10 10 10 10 10 10 10 10 10 10 10 10 27 23 24 23 23 
23 23 23 23 26 10 10 10 10 10 10 10 10 10 10 10 10 10 10 10 10 10 12 20 20 20 16 10 10 10 10 10 10 10 10 10 10 10 10 10 10 10 10 10 10 27 23 24 23 23 
23 23 23 23 26 10 10 10 10 10 10 10 10 10 10 10 10 10 10 10 10 10 12 20 20 20 15 10 10 10 10 10 10 10 10 10 10 10 10 10 10 10 10 10 10 27 23 24 23 23 
23 23 23 23 26 10 10 10 10 10 10 10 10 10 10 10 10 10 10 10 10 10 12 20 20 16 10 10 10 10 10 10 10 10 10 10 10 10 10 10 10 10 10 10 10 27 23 23 23 23 
23 23 23 23 26 10 10 10 10 10 10 10 10 10 10 10 10 10 10 10 10 10 12 20 20 16 10 10 10 10 10 10 10 10 10 10 10 10 10 10 10 10 10 10 10 27 23 23 23 23 
23 23 23 23 26 10 10 10 10 10 10 10 10 10 10 11 18 18 18 18 18 18 19 20 20 16 10 10 10 10 10 10 10 10 10 10 10 10 10 10 10 10 10 10 10 27 23 23 23 23 
23 23 23 23 26 10 10 10 10 10 10 10 10 10 10 12 20 20 20 20 20 20 20 20 20 16 10 10 10 10 10 10 10 10 10 10 10 10 10 10 10 10 10 10 10 27 23 23 23 23 
23 23 23 23 26 10 10 10 10 10 10 10 10 10 10 13 14 14 14 14 14 14 20 20 20 20 18 18 18 18 18 17 10 10 10 10 10 10 10 10 10 10 10 10 10 27 23 23 23 23 
23 23 23 23 26 10 10 10 10 10 10 10 10 10 10 10 10 10 10 10 10 10 12 20 20 20 20 20 20 20 20 16 10 10 10 10 10 10 10 10 10 10 10 10 10 27 23 23 23 23 
23 23 23 23 26 10 10 10 10 10 10 10 10 10 10 10 10 10 10 10 10 10 12 20 20 20 14 14 14 14 14 15 10 10 10 10 10 10 10 10 10 10 10 10 10 27 23 23 23 23 
23 23 23 23 26 10 10 10 10 10 10 10 10 10 10 10 10 10 10 10 10 10 12 20 20 16 10 10 10 10 10 10 10 10 10 10 10 10 10 10 10 10 10 10 10 27 23 24 23 23 
23 23 23 23 26 10 10 10 10 10 10 10 10 10 10 10 10 10 10 10 10 10 12 20 19 16 10 10 10 10 10 10 10 10 10 10 10 10 10 10 10 10 10 10 10 27 23 23 23 23 
23 23 23 23 26 10 10 10 10 10 10 10 10 10 10 10 10 10 10 10 10 10 12 20 20 16 10 10 10 10 10 10 10 10 10 10 10 10 10 10 10 10 10 10 10 27 23 23 23 23 
23 23 23 23 26 10 10 10 10 10 10 10 10 10 10 10 10 10 10 10 10 10 12 20 20 16 10 10 10 10 10 10 10 10 10 10 10 10 10 10 10 10 10 10 10 27 23 23 23 23 
23 23 23 23 26 10 10 10 10 10 10 10 10 10 10 10 10 10 10 10 10 10 12 19 20 16 10 10 10 10 10 10 10 10 10 10 10 10 10 10 10 10 10 10 10 27 23 23 23 23 
23 23 23 23 26 10 10 10 10 10 10 10 10 10 10 10 10 10 10 10 10 10 12 20 20 16 10 10 10 10 10 10 10 10 10 10 10 10 10 10 10 10 10 10 10 27 23 23 23 23 
23 23 23 23 26 10 10 10 10 10 10 10 10 10 10 10 10 10 10 10 10 10 12 20 20 16 10 10 10 10 10 10 10 10 10 10 10 10 10 10 10 10 10 10 10 27 23 23 23 23 
23 23 23 23 26 10 10 10 10 10 10 10 10 10 10 10 10 10 10 10 10 10 12 20 20 16 10 10 10 10 10 10 10 10 10 10 10 10 10 10 10 10 10 10 10 27 23 23 23 24 
23 23 23 23 23 25 25 25 25 25 25 25 25 25 25 25 25 25 25 25 25 25 25 25 25 25 25 25 25 25 25 25 25 25 25 25 25 25 25 25 25 25 25 25 25 23 23 23 23 23 
23 23 23 23 23 24 23 23 23 23 23 23 23 23 23 23 23 23 23 23 23 23 23 23 23 23 23 23 23 23 23 23 23 23 23 23 23 23 23 23 24 23 23 23 23 23 23 23 23 23 
23 24 23 23 24 23 23 23 23 23 23 23 23 24 23 23 23 23 23 23 23 23 23 23 23 23 23 23 23 23 23 23 23 23 23 23 23 23 23 24 23 23 23 23 23 23 23 23 23 24 
23 23 24 24 23 23 23 23 23 23 23 23 23 23 23 23 23 23 23 23 23 23 23 23 24 23 23 23 23 24 24 24 24 24 24 24 23 23 24 24 23 23 24 23 23 23 23 23 23 23 
23 24 23 23 23 23 23 23 23 23 23 23 23 23 23 23 23 23 23 23 24 23 23 23 23 23 24 24 24 24 23 23 23 23 23 23 23 24 24 23 23 23 23 23 23 23 23 23 23 23
